# $Id: standardized_sitenames_pretty.txt 1191 2011-02-17 22:45:41Z dgolden $
# Get the latest version of this mapping from http://spreadsheets.google.com/pub?key=tKQOK8JcBcKgI4lnEdGroZQ&output=csv

Adelaide=adelaide
Algeria=algeria
Allahabad=allahabad
Amargosa=amargosa
Amsterdam Island=amsterdam
Arecibo=arecibo
Argentina=argentina
Ascension=ascension
Austria=austria
Azerbaijan=azerbaijan
Belgrade=belgrade
Bermuda=bermuda
Berthoud=berthoud
Boston=boston
Boulder=boulder
Castlerock=castlerock
Cheyenne=cheyenne
Chistochina=chistochina
College Park=collegepark
Colorado Springs=coloradosprings
Crete=crete
Cyprus=cyprus
Dartmouth=dartmouth
Deltajunction=deltajunction
Dotlake=dotlake
Dublin=dublin
Ecuador=ecuador
Egypt=egypt
Elazig=elazig
Ethiopia=ethiopia
Ferraz=ferraz
Fiji=fiji
Fort Collins=fortcollins
Fort Yukon=fortyukon
Fountain=fountain
Gakona=gakona
Gander=gander
Goddard=goddard
Greatfalls=greatfalls
Green Mountain=greenmountain
Haarp=haarp
Healy=healy
Hobart=hobart
Homer=homer
Ireland=ireland
Israel (Hermon)=israel_hermon
Israel (Sde Boker)=israel_sdeboker
Israel (Tel Aviv)=israel_telaviv
Itapetininga=itapetininga
Japan=japan
Juneau=juneau
Kerguelen Island=kerguelen
Ketchikan=ketchikan
Keywest=keywest
Kodiak=kodiak
Kolkata=kolkata
Kwajalein=kwajalein
Las Vegas=lasvegas
Libya=libya
Littleton=littleton
Malaysia=malaysia
Melbourne=melbourne
Midway=midway
Minot=minot
Mongolia=mongolia
Morocco=morocco
Mountainvillage=mountainvillage
Nainital=nainital
Nancay=nancay
Nathaniel B Palmer=nathaniel_b_palmer
Nigeria=nigeria
Norvick=norvick
Oklahoma Central Region=oklahoma_central
Oklahoma Eastern Region=oklahoma_east
Oklahoma Northern Region=oklahoma_north
Oklahoma Southern Region=oklahoma_south
Oklahoma Western Region=oklahoma_west
Penguin P3=penguin_p3
Penguin WAIS Divide=penguin_wais
Penguin South Pole=penguin_sp
Packard=packard
Palmer=palmer
Parker=parker
Paxson=paxson
Perth=perth
Peru=peru
Philmont=philmont
Poker Flat=pokerflat
Pueblo=pueblo
Rothera=rothera
Rye=rye
Sanae=sanae
SPAWAR San Diego=sandiego_spawar
Santa Cruz=santacruz
Sheridan=sheridan
Shishmaref=shishmaref
Sienacollege=sienacollege
Slana=slana
Sondrestrom=sondrestrom
South Africa=southafrica
South Pole=southpole
Stanford=stanford
Swider=swider
Sydney=sydney
Talkeetna=talkeetna
Tangaroa=tangaroa
Tashkent=tashkent
Taylor=taylor
Trinidad=trinidad
Tunisia=tunisia
Sharjah=uae
Valdez=valdez
Varanasi=veranasi
Vernasky Station=vernadsky
Vieques=vieques
Waimea=waimea
Wallops Island=wallopsisland
Walsenburg=walsenburg
Wilcox=wilcox
Yakutat=yakutat
